
NO ./textures/planks.xpm
SO ./textures/grass.xpm
WE ./textures/torch.xpm
EA ./textures/attack_torch.xpm

F 77,92,53
C 163,208,230

111111111111111111111111
100000000000000000000001
100000000000000000000001
100000000000000000000001
100000222220000303030001
100000200020000000000001
100000200020000300030001
100000200020000000000001
100000220220000303030001
100000000000000000000001
100000000000000000000001
100000000000000000000001
100000000000000000000001
100000000000000000000001
111111111111111111111111
